000000000
000000000
000000000
000010000
000010000
111111111
111110000
000010000
000010000
000000000
000000000
000000000
25
500